000000001100000000001100
001100001100000000001100
000110001100000000001100
000000001100000000001100
001100000000000110000000
000110000000000110000000
000000001100001100001100
001100001100001100001100
000110001100001100001100
000000001100001100001100
001100000000001100000000