00000222000000000000
11111211111111111111
11119200102222222202
11000200103333333002
11111200100029000002
11000200100022133002
11333333333333183333
11009200100000122002
11229222123333133332
11009200100000100032
11001833393022133002
11332222222333183333
11009200111000201002
11999200123331111332
11009200100000000032
