111111110011111111110011
110011110011111111110011
111001110011111111110011
111111110011111111110011
110011111111111001111111
111001111111111001111111
111111110011110011110011
110011110011110011110011
111001110011110011110011
111111110011110011110011
110011111111110011111111